111111
100C01
1000E1
111111